11111111111111
12222222222221
13322332233221
12233223322331
11111111111111
